hjälper = helps
följer = accompany (walk with, i walk ) https://www.duolingo.com/comment/6760573
följer efter = follow (to follow someonne, walk behind)
förfölja = chasing someone
utreder = investigates
södra = south
visar = shows
framför = in front of
glad = happy
ledsen = sad
snygg = good looking
fin = nice, beautiful
ful = ugly
fel = wrong
rätt = right
rädd = afraid
rädda = save
religiös = religious  :relihös
Har du det bekvämt = are you comfortable?
bekväm = comfortable
berömd = famous
riktigt = really
riktig = real
viktigt = important
aldrig = never
alltid = always
omöjligt = impossible  + omojlit
möjligt = possible
ovanlig = unusual, unusually
vanlig = usual, common
samtidigt = simultaneously
intressant = interesting
historisk = historical historic
fråga = question
förstå = understand
allvarlig = serious
ögonblick = moment
särskild = special   :sarkhuild
rik = rich 
traditionell = traditional - tredikhonel 
effektiv = efficient effective
perfekt = perfect
skådespelare = actor
tvåspråkigt = bilingual
jättesnygg = very beautiful
jättestor  = very big
jättebra = very good, great
bra = good, greate
dålig = bad
värde = value
Varje = Every
värdefull = valuable
olycka = accident
olika = diffrent
samma = same
låt = let
låg = low
hög = high
hel = whole
helt = wholly, completely 
stänga = close
utanför = Outside
dömts = convicted
officiella = official
sist = last (Sist doesn't change with the grammatical gender, but gains the -a (Sista) in definite/plural.)
förra = former, previous, last 
först = first
nödvändigt = necessary 
använda = use
anlända = arrive
till exempel = for example
också = also
kanske = perhaps, maybe
tom = empty
full = full
dyr = expensive
billig = cheap, inexpensive
leva = live
gå = go
ge = give
få = receive
göra = do, make
studera = study
tänka = think
tänker = thinks
tackar = thank
tror = believes
ringa = ring, call
håll = hold
jag håller i = I hold (Think like, I hold in my hand) https://www.duolingo.com/comment/5610382
ser ut som = to looks like
verka = to seem
verkar some att = seems like
försöka = try
presentera = present
ligger på = situated at, lie down at
ligger = is, (present)
hos = with, at..place
behöver = needs
middag = dinner
frukost = breakfast
gaffel = fork
juice = juice
ord = Words
vakna = Wakeup
lön = Salary
företag = Company
yrke = profession
Ofta = Often
namn = Name
nivår = Level
kyssa = kiss
vilar = rests
orkar = have enough energy (Jag orkar inte nu: I have no energy now, I am tired now)
räcker = is enough
stämmer = is correct (is/ are included, det stammer : it is correct)
känner = senses/ feels/ knows (uttal: channer) - for people (I know him)
vet = know (knowledge)
slutar = stops/ ceases https://www.duolingo.com/comment/9400327/He-does-not-stop
stannar = stops / stays
lär = teachs
önskar = wishes
undrar = wonders
båda = both
sedan = then
de flesta = most of the
dör = dies
letar efter = looking for
titta = look
tittar på = looking at
säger = says
If verb is after noun = verb does not use definite form (child is good: barnet ar bra) (a good child: ett brat barn)